111111111111111
100001000010001
100001000040001
100004000010001
100001000010011
100001000010011
100001000100001
10000400N010001
100001000040001
111111111111111