1111111111111111
1000011000010001
1000011000040001
1000041000010001
10N0011000010011
1000011000010011
1000011000100001
1000041000010001
1000011000040001
1111111111111111