
NO ./images/north.xpm 


SO   ./images/south.xpm 

WE   ./images/west.xpm 

EA   ./images/east.xpm 
F 220,111,119
C 225,111,0


1111111
10S0011
1000011
1000041
1000011
1000011
1000011
1000041
1011111
1000011
1000011
1000011
1000011
1000011
1000011
1000011
1000011
1000011
1111111
