NO ./images/north.xpm 
SO ./images/south.xpm 
WE ./images/west.xpm 
EA ./images/east.xpm

F 220,111,119
C 225,111,0

111111111111
1000400S0011
100010000011
100010000001
100040000001
100010000001
100010000001
100040000001
100011100111
111111111111