NO ./images/north.xpm 
SO ./images/south.xpm 
WE ./images/west.xpm 
EA ./images/east.xpm

F 220   ,  111  ,  119
C 225  ,   111  ,   0

1111111
10S00101
10000101
10000401
10000101
10000101
10000101
10000401
10111101
 1 111111
                 
 111111
10000101
10000101
10001001
10000101
10000101
10000101
10000101
10000101
10000101
1111111
 
