1111111
1000011
1000011
1000041
10N0011
1000011
1000011
1000041
1000011
1111111