1111111111111111111
1100000000000001111
1000000000000001111
1000000000000001111
1000000000000001111
1000000000000001111
1000000000000001111
1000000000000001111
1000000000000001111
1000000000000001111
1000000000000001111
100000000E000001111
1000000000000001111
1000000000000001111
1000000000000001111
1000000000000001111
1000000000000001111
1000000000000001111
1000000000000001111
1000000000000001111
1000000000000001111
1000000000000001111
1000000000000001111
1000000000000001111
1000000000000001111
1200000000000001010
1111111111111111111