NO ./images/north.xpm 
SO   ./images/south.xpm 
WE   ./images/west.xpm 
EA   ./images/east.xpm 

F 220,111,119
C 225,111,0

1111111111111
1100000040001
1000000010001
1000N00040001
1100000110001
1111111111111