11111111111
10000001111
10000001111
10000001111
10010001111
10010N01111
10010001111
11111111111