
NO ./images/north.xpm 


SO   ./images/south.xpm 

WE   ./images/west.xpm 

EA   ./images/east.xpm 


C  33,0,255

F  255,0,133 

111111111111111111111111111111111111111
100000000000000000000000000100001000001111
111111111111111000000000011 100011000000001
100000000000000000000000000100001000001111
10W011111111111111111111111111111111111
100000000000000000000000000000000000001
111111111111111111111111111111111111111