NO ./images/north.xpm 



SO   ./images/south.xpm 

WE   ./images/west.xpm           

EA   ./images/east.xpm 

C  0,0,255

F  255,0,0

   1
11111111111111
10011001111
10041011111111111111111111111111111
1001100111000000011 1      100011
10040S0111110100000101     1111111S1111111
1001000111111 1111111111111111111111111
1001030000000100000000000000000000001111 
10111011111111111111111111111111111111
101101111101
1111111111111
1
1