
SO ./images/south.xpm 
NO ./images/north.xpm 
WE     ./images/west.xpm 
EA ./images/east.xpm 
        
C 1,0,255
F 255,0,133 
    
111111111
1000000001
100000001
1111110001
111110000111
11   111111
  
1111111111111
1110000001
1000W00001
1000000001
1111111111