NO ./images/north.xpm 



SO   ./images/south.xpm 

WE   ./images/west.xpm           

EA   ./images/east.xpm


C  3,0,255

F  25,0,133

   
 11111111 1111111
 10011001111
 10041011111111111111111111111111111
 10011001110000000111100011111111111111
 10040011111010001    111        10010111111   111111111
 1001000111311111111111111111111111111111111
 10010300000001000000000S00000000000000101
 10111011111111111111111111111111111111111
 101101111101
 1111111111111
101
11
