NO ./images/north.xpm 



SO   ./images/south.xpm 

WE   ./images/west.xpm           

EA   ./images/east.xpm 

C  0,0,255

F  255,0,0

   
11111111111111
10011001111
10041011111111111111111111111111111
10011001110000000111100011
10040011111010000010111111111111111
10010001111111111111111111111111111111
1001030000000100000000000000000000001111 
10111011111111111111111111111111111111
101101111101
1111111111111
1
1