11111111
10000001
10000001
10000001
10000001
10000001
10000021
11111111