NO ./images/north.xpm 



SO   ./images/south.xpm 

WE   ./images/west.xpm           

EA   ./images/east.xpm 

C  0,0,255

F  255,0,0

          1
       111111111111111111111111111111111111111111111111111111
    11100011110011111110011000000000001110000000000001110000011
111100001111110011111110011001111110001111111111110001100000011
11000111111111001111111001100111111000111111111111100011001100011
1100111111111100111111100110000000001111111111111000001100111100111
1100111111111100111111100110011111111111100000000000011100111111001
11001111111111001111111001100111111111111111111111100111001111111001
1100111111111100111111100110000000000011111111111110011100111110001
1110001111111100111111100110011111111000111111111111001100111110011
  11100011111100000W0000011001111111100111111111110011110011100111
    100000111100000000000110000000000011100000000001111100100011
 1111111111111011111111101101111111111111011111111111111000011
10000000000000000000000000000000000000000000000000000000000011
 111111111111111111111111111111111111111111111111111111111111
