NO ./images/north.xpm 
SO   ./images/south.xpm 
WE   ./images/west.xpm 
EA   ./images/east.xpm 

F 220,111,119
C 225,111,0

         11111111111111111111111111111111111111111111
         100000000011000000000000000000000000000000001
         1000000000110000W0000000000000000000000000001
         1000000000110000000000000000000000000000000001
1111111110110000011100000000000011111111111111111111111
100000000011000001110111111111111
11110111111111011100000010001
11110111111111011101010010001
11000000110101011100000010001
10000000000000001100000010001
10000000000000001101010010001
11000001110101011111011110001
11110111 1110101 101111010001
11111111 1111111 111111111111