
11111111
10000001
10000001
     10000001
10010001
10010N01
10010001
11111111