11111111
10000001
10000001
10000001
10010001
10010001
10010021
11111111