
NO ./images/north.xpm 
SO ./images/south.xpm 
WE ./images/west.xpm 
EA ./images/east.xpm 

C 33,0,255
F 255,0,133 

1111111111
1000000001
1000000001
1111110001
1111100001
1111000001
1110000001
1000000W01
1000000001
1111111111